jonan komisi energi dpr rapat jam hasil	neutral
polres muara enim bongkar tambang batu bara ilegal orang tangkap	negative
polisi tutup tambang emas ilegal kawasan gunung sanggabuana bogor	negative
orang jadi sangka tambang ilegal klaten ngotot punya izin	negative
gubernur jambi soal sungai batanghari bersih dprd segera buat perda	positive
warga pakuniran probolinggo keluh tambang sirtu rusak lingkung	neutral
satpol pp batang sambat gali c ilegal tutup selalu muncul	negative
polisi razia tambang emas ilegal rangin laku tangkap	negative
wn china paspor papua aman tni	neutral
jagung bentuk satgas evaluasi tata kelola tambang timah	neutral
wow kades hariyono keruk rp juta per bulan tambang pasir ilegal	negative
duh pasir pantai ntb gali ilegal	negative
modus baru balik aktivitas tambang ilegal sukabumi	negative
patroli tambang ilegal polda banten tutup tambang emas lebak	negative
kkb serang kerja tambang awimbon papua pimpin bocor sobolim	neutral
tambang emas ilegal bungo jambi razia alat berat aman	negative
minta tutup warga geruduk tambang gali c jatisari boyolali	neutral
polisi dinas esdm jateng cek tambang ilegal klaten titik izin	negative
suram harga bitcoin nyaris jeblok bawah rp juta	neutral
istri salim kancil sakit hati mau juang bung karno	positive
wanita kolombia perkosa lapor kasus perkosa	neutral
polisi tangkap tambang pasir ilegal riau	negative
calegnya tahan dpc ppp rembang tak ikut campur	neutral
ribu liter solar ilegal aman polres tuban	negative
tambang emas ilegal kuansing longsor tambang tewas	negative
kompolnas minta ppatk cek alir dana oknum polisi bos tambang emas ilegal	negative
dprd jatim jangan ulang salim kancil ii	neutral
pns rohul jadi sangka usai jadi kebun sawit tambang pasir batu ilegal	negative
pn kendari tolak gugat pra adil kasus iliegal mining kolaka	negative
laku tambang batu bara ilegal kukar tangkap ekskavator sita	negative
tangkap tambang emas ilegal gakkum klhk ajak warga jaga tn lore lindu	negative
seleweng izin wn china korsel tambang emas nabire deportasi	neutral
polisi tangkap wna duga laku tambang ilegal aceh	negative
suku paling isolasi hutan amazon tampak diri	positive
maros sulsel terjang banjir bandang bupati gara gara tambang liar	negative
polisi temu aktivitas tambang emas ilegal singkawang	negative
gubernur aceh tutup tambang ilegal laku tindak	negative
tambang emas jambi longsor tambang timbun	neutral
polisi periksa duga terima uang usaha tambang lumajang	neutral
polres bogor tangkap tambang emas ilegal area milik pt antam	negative
lokasi oplos solar gerebek tim gabung pertamina polisi	neutral
polisi kalong beku gali c ilegal bas truk sita	negative
punya bitcoin gratis paham sistem mining	positive
dampak keri tambang emas ilegal kaki gunung sanggabuana	negative
acara hendra kurniawan ismail bolong bohong	neutral
jurnalis inggris tembak mati amazon bunuh	negative
dedi mulyadi minta polda jabar tindak tambang ilegal guna ledak	negative
miris lahan kubur sumedang jadi lokasi tambang ilegal	negative
polisi babat habis tambang emas ilegal kalbar orang cukong aman	negative
menteri sus tak punya timah kok thailand ekspor timah	neutral
sangka kasus tambang sebab orang tewas tangkap	neutral
sofyan djalil ri produsen timah besar no dunia nggak apa apa	neutral
tambang emas tutup warga pancurendang banyumas jadi ternak dada	negative
gibran sebut tambang ilegal klaten punya beking ngeri	negative
alat berat tambang emas ilegal bungo bakar warga	negative
milik tambang pasir longsor mojokerto periksa polisi	neutral
soal kasus timah usut jaksa usai harvey moeis jadi sangka	neutral
tiga kades mojokerto jerat korupsi tambang ilegal	negative
ratus tambang pasir batu milik armada angkut mineral demo	neutral
jokowi tunjuk menteri esdm pimpin benah tambang timah babel	neutral
tambang pt map cemar air limbah oli labu bajo duga liar	negative
korban tewas akibat topan vamco filipina jadi orang	neutral
respons dpr rmk energy bantah soal tambang ilegal	negative
tambang batubara ilegal gerebek polres tuban	negative
tambang batu bara ilegal juta tontahun produksi	negative
emak emak semprot tugas kejar sukabumi gegara plang sita lahan	negative
legislator minta kasus ismail bolong sepele	neutral
sorot gaya gibran debat tb hassanudin ilmu sampai	neutral
tunggu perintah jokowi sus siap tertib tambang timah ilegal babel	negative
bos pt timah lapor polisi tambang ilegal marak babel	negative
warga sumbar tangkap duga buka tambang emas ilegal madina	negative
skandal facebook data	neutral
keren lahan eks kartel gurandil pongkor sulap jadi tempat wisata	positive
banjir bandang jambi rumah hanyut orang hilang	negative
polisi aman orang kait tusuk kapolsek sandera jambi	negative
marak tambang ilegal punya beking ngeri menteri esdm mau bentuk ditjen baru	negative
cegah timah ilegal jokowi rombak atur soal timah	negative
menteri desa ikut ingat hari mati salim kancil	neutral
kapolres madina dandim tapsel tepis jemput paksa mafia tambang	positive
bahas tambang emas ilegal anggota dprd jambi warga nyaris adu jotos	negative
tambang ilegal bikin resah bijak daerah bikin gerah	negative
tambang minyak ilegal batanghari gerebek tambang aman	negative
tambang batu bara ilegal bukit soeharto kaltim gerebek jadi sangka	negative
eks dirops pt timah jadi sangka korupsi rugi negara rp t	neutral
ganjar minta setop tambang sungai klaten hulu rapi tetap jalan	neutral
soal timah ilegal babel menteri siti sana mah parah	negative
warga ngeluh aktivitas gali c majalengka ancam lingkung	neutral
uruk proyek tol jogja solo henti imbas tambang bikin mletre segel	negative
polres malang mulai bidik tambang pasir ilegal	negative
bos gali c ilegal kalong resmi jadi sangka	negative
polisi bekuk laku tampung emas hasil tambang liar jambi	negative
dlh kalsel sidak tambang batu bara ilegal cemar sungai mangkauk	negative
iran resmi larang tambang bitcoin alas bikin heran	neutral
bos pt timah buka suara soal rugi lingkung rp triliun	neutral
keji begini kronologi bunuh aktivis anti tambang lumajang	neutral
suling merkuri hutan malu bongkar pasutri tangkap	neutral
polisi tertib tambang emas ilegal luwu utara usai tewas tambang	negative
kisah muram balik hidup gurandil sukabumi	negative
jagung jelas kait harvey moeis helena lim kasus timah	positive
gubsu edy cemar bahan kimia sebab anak stunting madina	neutral
ipw minta testimoni ismail bolong soal kabareskrim usut biar tak fitnah	neutral
gunung emas kaki salak	neutral
aktivis anti tambang bunuh menteri agraria gali ilegal henti	negative
ipl bangun bendung bener nilai cacat substansial	negative
polres diri gerebek lokasi tambang pasir ilegal	negative
hilir sebut ugal ugalan eks mendag emang mau jaga lingkung aja	positive
anggota dewan mojokerto milik gali c ilegal periksa polisi	negative
bisa ri jadi tentu harga timah dunia	neutral
dampak keri manusia tambang emas ilegal gunung sanggabuana	negative
kronologi tambang emas ilegal parigi moutong tewas timbun longsor	negative
indah pandang waduk waris soeharto sedang sekarat	positive
main mata tambang timah	neutral
negara negara amazon kumpul brasil bahas bijak sama	negative
maut lubang tambang emas bolmong	neutral
respons adu warga ganjar tindak gali c ilegal lereng sindoro	negative
china benar benar hancur bitcoin	neutral
operator alat berat jadi sangka tambang ilegal rapi magelang	negative
gubsu edy stunting madina duga kuat picu cemar tambang ilegal	negative
cuan ratus juta ternak ayam eks gurandil hidup lebih barokah	positive
tebing blitar longsor tambang pasir luka	neutral
warga pidie serah pucuk m sisa konflik polisi	neutral
tak ekspor biji bauksit ri malah selundup malaysia	neutral
tampak kapal angkut pasir ilegal pulau rupat riau aman kkp	negative
sus minta jokowi berantas tambang timah ilegal bangka belitung	negative
kadiv propam polri polisi lumajang aku baru bulan terima uang tambang	positive
tilik aktivitas tambang emas ilegal mirip pasar sukabumi	negative
tragedi jadi lumajang perintah nilai tak konsisten tata lahan	neutral
dapat berlian afrika tak nikmat rakyat banyak	positive
polisi sita ton pasir timah ilegal tiga laku bangka	negative
soal tambang ilegal babel mendag gobel malaysia mana timah	negative
bedeng tambang emas ilegal banyumas bongkar buntut tambang jebak	negative
parah listrik kantor polisi curi buat tambang bitcoin	negative
razia tambang ilegal gunungkidul polisi sita alat berat truk	negative
tragedi tambang emas ilegal bengkayang kalbar tewas orang	negative
polisi bantah cekcok tni tangkap tambang ilegal	negative
kisah kota paling tinggi dunia sedih	negative
ciri ciri pria misterius siram air keras wartawan bangka	neutral
gerebek tambang ilegal magelang alat berat sita orang periksa	negative
kasus ismail bolong lapor propam polri	neutral
suku pencil brasil ancam corona gegara tambang ilegal	negative
polisi tangkap orang kait tambang ilegal sorot andre rosiade	negative
cara menteri esdm tambang timah ilegal hilang	negative
maut lubang viral kaya emas sukabumi	positive
jabar hari kisah cinta bujang lapuk hingga misi persib sisa laga	positive
perintah khusus kapolri kapolda sulteng buru tangkap teroris santoso	positive
polisi tenggelam mesin operasional tambang emas ilegal riau	negative
ketua komisi iv dpr minta dalang bunuh tani anti tambang ungkap	negative
dpr panggil menteri esdm lhk bahas tambang ilegal	negative
pasir darah lumajang	negative
sumur minyak ledak aceh apa tahu jauh	positive
tambang timah ilegal babel kini jadi perhati jokowi	negative
usaha jual lahan pemprov jabar kereta cepat lapor	positive
tambang segel kirim ribu rit tanah uruk tol jogja solo tunda	neutral
ferdy sambo aku pernah usut libat polisi tambang ilegal kaltim	negative
tumbal darah salim kancil	neutral
polisi buka mungkin polemik tambang ilegal selesai adat	negative
tambang ubah muka bumi begini tampak langit	neutral
orang jadi sangka kasus tambang longsor bikin orang tewas	negative
esdm tambang sirtu ilegal probolinggo polisi tindak	negative
angkut ton batu bara tambang ilegal sopir sumsel jadi sangka	negative
ancam lahan tani tambang pasir muara opak bantul protes	neutral
orang tewas tambang timah babel lama tahun akhir	neutral
sar intensif cari korban km sinar bangun cipali ramai lancar	positive
berantas kapal ilegal batu bara	negative
datang komnas ham jurkani minta usut kasus advokat bunuh kalsel	neutral
pp harap jamin lindung ekosistem pesisir laut	negative
rusak parah begini tampak hutan amazon luar angkasa	neutral
tambang timah ilegal tangkap konservasi bukit mangkol	negative
luhut cak imin tuding hilir ugal ugalan jangan bohong	neutral
hadap sarpin effect polda kalbar harap hakim pakai hati nurani	neutral
polisi aman kontainer sianida halsel syahbandar ekspedisi periksa	positive
polisi terima suap tambang ilegal mutasi polri pidana tetap lanjut	negative
monumen bangun gali usai cari tambang banyumas henti	neutral
dalih salur csr bikin crazy rich helena lim jerat jadi sangka	negative
hutan sebut kso kph bogor sesuai atur	neutral
polisi ungkap tambang emas ilegal papua barat laku tangkap	negative
polda banten periksa saksi tambang emas ilegal tnghs lebak	negative
kacau marak tambang batu bara ilegal rau bikin resah	negative
daftar kasus besar ungkap komjen listyo sigit di bareskrim	positive
akses jalan jadi kendala evakuasi korban longsor tambang ilegal sumbar	negative
afrika minta raja inggris kembali berlian mahkota ratu elizabeth ii	neutral
skk migas siap bantu atas ledak sumur minyak aceh timur	positive
tampak hancur bangka belitung google maps	neutral
kerja tambang batu bara ilegal china tewas banjir	negative
kelola tambang ilegal pati blora tangkap	negative
mantan petinggi intelijen nilai izin tambang emas sangihe sah	neutral
cak imin kritik hilir sektor tambang ugal ugalan	neutral
lima tambang emas ilegal nagan raya aceh tangkap	negative
dedi mulyadi warga wadas tolak tambang sah tanda nasionalis	positive
tambang emas runtuh satu tewas	negative
tambang kaya dadak malam temu batu langka	positive
polisi aman sangka tambang emas ilegal riau	negative
jalan sleman rusak akibat tambang ilegal pemkab baik tambang	negative
jadi sangka tambang ilegal ismail bolong ancam tahun bui	negative
aktivitas tambang emas ilegal cibuluh sukabumi masih geliat	negative
tambang pasir ilegal tlogowatu klaten gerebek polda ekskavator sita	negative
aparat buru tka china kabur sukabumi	negative
kasus lumajang dprd jatim minta polisi usut ada anggota dewan libat	neutral
celah atur smelter pakai timah ilegal	negative
titik longsor gunung halimun salak sebab banjir lebak	neutral
proyek gali c ilegal majalengka segel polisi	negative
teror tiga wartawan lumajang tangkap	neutral
tambang tanah ilegal pekanbaru tangkap alat berat ikut sita	negative
polisi tutup paksa tambang pasir ilegal lumajang	negative
langgar hak temu komnas ham bunuh salim kancil	neutral
polisi malaysia buru tambang bitcoin liar pakai drone	negative
wna tangkap lokasi tambang emas ilegal aceh status saksi	negative
tambang emas ilegal sumut gerebek kerja aman	negative
polri sangka aniaya salim kancil jerat illegal mining	negative
isu perang bintang heboh ismail bolong sahroni usul polri bentuk timsus	positive
suami sandra dewi harvey moeis jadi sangka korupsi timah	neutral
deportasi wna sri lanka nekat tambang emas ilegal gorontalo	negative
tambang emas ilegal lombok tengah tutup paksa	negative
menteri lhk minta kerja sama setop rantai dagang merkuri ilegal	negative
suram begini masa depan ekonomi afghanistan usai asai talib	neutral
asrama pusdik brimob ancam longsor tambang sirtu tutup	negative
lima negara mati aktivis lingkung	negative
tambang ilegal rapi razia bupati klaten minta polisi tak tebang pilih	negative
emas batang ilegal nila rp m sita polisi sulsel	negative
kodam mulawarman tegas pangdam polda tak libat tambang ilegal ikn	negative
tambang jebak longsor jam lebak hasil selamat	positive
berkas kasus ismail bolong ke tangan jaksa	neutral
kawasan hutan hilang sebab bencana banjir besar jambi	positive
siapa beking ngeri gede gede balik tambang ilegal klaten	negative
lihat nenek boyolali tambang pasir sungai hulu rapi	neutral
sosok ismail bolong nyata mantan anggota polresta samarinda	neutral
lokasi tambang emas ilegal sukabumi gerebek polisi	negative
badan informasi geospasial tambang gunung rapi lampau batas	neutral
oknum polisi duga terima uang tambang pasir ilegal lumajang	negative
massa tutup paksa tambang ilegal sungai batang mayoritas emak emak	negative
gali c ilegal jombang tutup paksa tugas gabung	negative
gali c ilegal tutup paksa puluh dump truk eskavator sita	negative
lokasi tambang emas liar gunung pongkor longsor	negative
tambang ilegal lereng rapi razia harga pasir lambung	negative
polisi sita truk angkut ton batu bara ilegal sumsel	negative
tagih listrik naik waspada serang cryptomining cara cegah	neutral
sumur minyak ilegal batanghari bakar polisi buru laku	negative
hari ton timah ilegal ekspor babel siapa nikmat	negative
dampak ngeri balik tambang ilegal mau digrebek ganjar	negative
tambang keruk tambang ilegal pt timah rugi rp triliun	negative
komnas ham minta polri usut tuntas kasus tewas salim kancil	neutral
jahat mojokerto jadi tiap jam panjang	neutral
jurnalis inggris hilang amazon brasil desak intensif cari	negative
bareskrim limpah berkas perkara tambang ilegal ismail bolong jagung	negative
tambang emas ilegal berantas dpr dukung	negative
mahasiswa demo pemprov sulut tuntut izin tambang emas sangihe cabut	neutral
polisi bongkar kasus tambang ilegal jabar	negative
polda kalteng ungkap edar sianida ton laku tangkap	neutral
tambang pasir ilegal sungai progo aman polisi	negative
wn china tangkap manokwari libat tambang emas ilegal	negative
vonis tahun bulan gurandil sukabumi eksekusi bui	negative
tambang emas ilegal sumbar longsor empat kerja timbun	negative
bekal alat bukti polisi tetap sangka teror wartawan	neutral
tiga bulan culik gerilyawan kolombia turis selamat	neutral
polisi tertib tambang pasir ilegal rapi orang tahan	negative
gibran ungkap beking ngeri tambang ilegal klaten polres usut kasus tahun	negative
dpr minta esdm beku rmk energy duga laku tambang ilegal	negative
soal periksa eks kapolres kapolres lumajang kata kapolda jatim	neutral
merkuri ilegal asal sidoarjo jual rp juta per kg	negative
heboh ratu batu bara komisi vii dpr panggil tan paulin senayan	positive
tambang pasir ilegal sungai porong gerebek milik politis pdip	negative
mahasiswa jember demo tolak izin tambang blok silo	neutral
klh gandeng asosiasi tambang rakyat upaya tambang emas bebas merkuri	neutral
tambang emas ilegal camat kabupaten bogor tutup polisi	negative
mesin tambang bitcoin sita perintah malaysia	neutral
ganjar sebut beking tambang ilegal klaten gede gede puser bumi tak efektif	negative
tambang emas liar sukabumi makan korban orang tewas timbun	negative
hitung rugi alam tambang timah bangka belitung nilai triliun	positive
tambang timah ilegal kepri tangkap jadi sangka	negative
ridwan kamil colek menteri esdm minta bumd garap sumur tua	positive
usaha tambang sultra polisi duga tambang izin	neutral
bor minyak ilegal rantau peureulak aceh pernah tindak	negative
tambang ilegal jateng pemprov bentuk tim padu	negative
klhk aman sangka kasus tambang nikel ilegal desa oko oko	negative
polda sumbar tangkap tambang emas ilegal sorot andre rosiade	negative
warga minta pihak tangkap soal tambang emas ilegal tetap proses hukum	negative
dprd jambi ingat pj bupati sarolangun soal tambang emas ilegal	negative
jagung usaha boneka kait kasus korupsi timah stop operasi	positive
aju praperadilan pihak sangka tambang ilegal yakin maladministrasi	negative
milik gali c ilegal aceh besar tangkap alat berat sita	negative
maki lapor kejat sulteng jagung soal simpang lo tambang nikel	positive
bupati blora ungkap longsor bengawan solo imbas tambang pasir ilegal	negative
kapal angkut kayu pasir ilegal tangkap riau orang aman	negative
polda sultra tetap direktur pt dms jadi sangka tambang ilegal	negative
jual barang fashion ilegal kulit ular selebgram tajir polisi	negative
polisi segel lokasi tambang emas ilegal viral nanggung bogor	negative
hasil rp m bos tambang pasir ilegal batam bekuk polisi	negative
plt jubir deputi cegah kpk akan lapor dewas	neutral
andre rosiade minta polda sumbar cek tambang pasir pantai pasie jambak	neutral
tni bakal bantu berantas tambang ilegal	negative
tambang emas tewas kuansing riau polisi minta turun tangan	negative
dukung singkong salim kancil pilkades hariyono balas darah	neutral
angkut padas truk hari milik lahan semarang jadi sangka	neutral
orang duga timbun longsor tambang bolmong sulut	negative
jokowi buka suara soal nasib kontrak freeport	neutral
petaka pantai matras	neutral
bos tambang nikel ilegal sultra jadi sangka alir dana telusur	negative
klhk sulawesi tangkap milik tambang emas ilegal parigi mautong	negative
tutup akhir tahun usaha ngeluh harga batu bara anjlok	negative
peran suami sandra dewi kasus korupsi massal pt timah	neutral
simak momen penting kripto panjang	positive
polri segera limpah kasus tambang ilegal ismail bolong	negative
tambang emas liar sulut tewas timbun longsor orang luka	negative
tambang kumbung ambrol empat kerja luka luka	neutral
ketua dpr minta negara pulih kawasan tambang ilegal pongkor	negative
gerebek tampung emas ilegal polisi sita emas nila rp m	negative
bunuh sadis tani anti tambang sangka kesal demo	negative
jabar hari tewas gurandil tambang ilegal tuntut pns ma	negative
klhk bongkar tambang ilegal kolaka orang sangka ekskavator sita	negative
rekan ismail bolong tetap jadi sangka kasus tambang ilegal	negative
praktik ilegal sektor migas mau berantas perintah	negative
harvey moeis suami sandra dewi sangka korupsi timah pakai rompi pink	negative
tangkap tambang ilegal polisi sita alat berat milik anggota dprk simeulue	negative
maki temu mahfud bahas ruu ampas aset duga korupsi batu bara	negative
suasana cekam gegara tambang ilegal sidrap polisi minta tindak	negative
polisi musnah alat tambang emas ilegal riau	negative
walhi kades hariyono perlu jerat pasal tipikor cuci uang	neutral
ketua dprd lumajang anak nakal masuk tim	negative
daftar lokasi tambang emas hingga timah ilegal ri	negative
tambang timah ilegal bikin apple urung bikin pabrik ri	negative
tambang pasir ilegal blitar aman truk alat berat sita	negative
dpr rapat menteri esdm klhk jam hasil	neutral
marak tambang timah ilegal negara rugi rp ttahun	negative
polisi tangkap laku tambang emas ilegal kuansing riau	negative
jagung tetap sangka kasus korupsi komoditas timah	positive
blokir jalan warga sleman demo tolak tambang pasir	neutral
kecewa fatmah cicah gagal temu suami sidang gurandil	negative
tambang emas ilegal asal jawa tengah bekuk rangin	negative
perintah china haram semua transaksi uang kripto	neutral
polisi gerebek tambang emas ilegal jayapura orang aman	negative
polres boyolali gerebek gali c ilegal orang tahan	negative
polda aman kg emas hasil peti	positive
satpol pp probolinggo tutup tambang pasir ilegal	negative
daftar negara larang legal bitcoin	neutral
korban tambang emas longsor sumbar jadi orang tewas	neutral
tambang batu gunung ilegal taput tangkap	negative
sumur minyak ilegal blok cepu jamur negara rugi besar	negative
jelas gubernur jatim soal tambang pasir lumajang	neutral
tambang emas ilegal tasikmalaya tertib tugas gabung	negative
pemprov banten sebut cukong tambang emas ilegal kabur lebak	negative
tambang ilegal marak sofyan djalil panggil tambang hingga eksportir	negative
rakor sidik polri ppns kabareskrim bicara modus jahat	neutral
sangka nekat olah merkuri bayar utang rp miliar	negative
waduk saguling kritis jadi septic tank besar dunia	neutral
fakta fakta korupsi timah rp triliun jerat suami sandra dewi	neutral
tambang timah ilegal marak babel dpr sudah cukup lama	negative
polda kepri tindak tambang ilegal omset rp m	negative
dor kerja tambang emas ilegal kuansing tembak warga	negative
geger testimoni ismail bolong abraham samad ungkap banyak masalah tambang	positive
klhktetapkan sangka tambang batu bara ilegal wilayahikn	negative
atas kritis mineral timah	neutral
timpa batu tambang timah bangka tewas dasar sungai	neutral
tambang ilegal bangka tengah longsor orang tewas	negative
cegah banjir ulang hilir sungai rangkui pangkalpinang keruk	neutral
tambang ilegal kawasan suaka margasatwa dang tangkap	negative
kedung londo pesona alam ikan energi positif wisatawan	positive
wanita libat tambang emas ilegal bulungan tangkap jakarta	negative
walhi hektare hutan aceh rusak akibat tambang emas ilegal	negative
maki sebut kpk lembek hadap lukas enembe	positive
orang tewas bantai kolombia	negative
tetap sangka polisi kejar dpo kasus salim kancil tosan	neutral
wagub jatim tandatangani resolusi lumajang damai	positive
cari korban polisi warga gali runtuh tambang emas sumut	negative
evakuasi tambang emas banyumas tim sar kerah pompa	neutral
dprd lebak minta polisi transparan usut gurandil hutan larang baduy	neutral
temu menteri esdm bandung bos bos bumn curhat soal illegal mining	negative
polisi tangkap tambang pasir timah ilegal babel	negative
masyarakat peduli kendeng istigasah tambang pabrik semen setop	neutral
klhk kaltim tangkap tambang batu bara ilegal kawasan ikn nusantara	negative
nusra pek jokowi resmi jalan golo mori bakar atribut perindo	neutral
tambang emas ilegal tewas lahan hutan sukabumi	negative
klarifikasi roy marten duga libat usaha tambang masalah	negative
maki lapor usaha nikel duga rugi negara triliun rupiah	negative
jagung berkas ismail bolong kait kasus tambang ilegal lengkap	negative
hati hati jalan raya cilegon arah serang penuh tanah	positive
polisi selidik tambang longsor renggut nyawa bocah manggarai timur	neutral
kki warsi kira rusa alam jambi rugi negara rp t	positive
soal akhir cari orang tambang emas ilegal banyumas	negative
direktur usaha tangkap kait tambang ilegal tanah bumbu kalsel	negative
waduh ada tambang ilegal ri banyak sumsel	positive
ribu warga pancurendang banyumas kini nganggur usai tutup tambang emas	neutral
sorot tambang jebak banyumas pakar unsoed siapa kepul	negative
fakta kini ismail bolong ancam tahun bui	positive
tambang batu bara ilegal rau tangkap ekskavator sita	negative
polda jatim lpsk desak lindung wartawan teror lumajang	neutral
mandi minyak ilegal ujung maut aceh	negative
polisi tetap tambang emas ilegal sukabumi sangka	negative
polisi ingat tambang awimbon rawan serang kkb nyawa taruh	negative
babel rusak akibat tambang timah malaysia thailand untung	neutral
tambang ilegal rajalela begini siasat	negative
bongkar tambang timah ilegal klhk dihadang warga babel	negative
kendala sopir truk polisi sulit ungkap tadah pasir ilegal	negative
kronologi libat suami sandra dewi harvey moeis korupsi timah	neutral
modus tambang timah ilegal puluh tahun babel	negative
tambang ilegal tangkap di ikn ngaku beking pangdam kapolda	negative
dakwa tambang ilegal pasuruan vonis tahun bulan bui jaksa banding	negative
helikopter militer jatuh kolombia tentara pasti tewas	positive
usaha kapal tambang pasir pulau rupat proses hukum	positive
keruk tahun emas tambang legenda pongkor tip	neutral
maki usul tim presiden bantu usut kasus tambang ilegal	negative
polda jatim buru aktor utama bunuh aktivis anti tambang salim kancil	positive
ledak milik sumur minyak setor kades rp ribudrum	neutral
adil tinggi jatim berat hukum bos tambang ilegal pasuruan	negative
daerah banyak jadi tambang pasir ilegal	negative
tambang milik anggota dprd maros demo warga di tempat keramat	neutral
talib jarah kaya afghanistan	neutral
antisipasi tambang liar brimob sisir pantai watu pecak	negative
kapolsek tusuk razia tambang emas ilegal jambi mulai pulih	negative
klhk pasti pres tambang ilegal tangan lanjut	negative
tambang batubara ilegal rugi negara rp triliuntahun	negative
tambang gamping ilegal pangandaran longsor timpa rumah warga	negative
hakim cecar hutan soal simpul tambang ilegal sukabumi	negative
tambang timah ilegal marak babel kata menteri esdm	negative
sakit paru ubah budhpura india jadi desa janda	neutral
lubang gali emas sukabumi ambruk gurandil tewas timbun	neutral
hektare tambang emas ilegal duga jadi sebab longsor lebak	negative
tuju komisi iii dpr kunker lumajang	neutral
tambang emas ilegal aceh tangkap alat berat sita	negative
sekda ntb sempat minta tambang pasir besi tutup	negative
korban tewas longsor tambang emas ilegal sulteng jadi hilang	negative
tahun operasi lokasi tambang ilegal langkat tindak	negative
warga lumajang resah bunuh kapolda jatim sila lapor saya	neutral
koordinasi mantap polisi bakal tutup tambang liar blitar	positive
duel sengit warga tambang pasir liar tengah bengawan solo	negative
ferdy sambo angkat bicara soal geger ismail bolong kait tambang ilegal	negative
orang kerja tewas kades milik tambang ilegal rembang jadi sangka	negative
alas balik mundur rencana apple bikin pabrik ri	negative
warga bakar alat berat tambang emas ilegal jambi	negative
truk larang operasi gegara bikin macet sopir jambi rugi	neutral
dprd klaten soal geger tambang ilegal uu minerba perda rtrw tak jalan	negative
tahan polda jatim dia sangka bunuh salim kancil	neutral
bekas lokasi tambang ilegal selok awar awar tanam ribu mangrove	negative
kronologi sumur minyak ilegal batanghari bakar tewas korban	negative
modal tambang emas ilegal milik toko aceh tangkap	negative
warga china tak paspor nambang emas papua periksa imigrasi	neutral
komisi iii dpr minta mabes polri periksa kapolres eks kapolres lumajang	neutral
tambang emas ilegal wna asal jepang deportasi timika	negative
kata bos pt timah soal heboh rugi lingkung rp triliun	positive
caleg ppp tahan kejar rembang kait tambang ilegal	negative
polri selamat aset negara rp t kasus korupsi lama	neutral
soal tambang gali c ilegal kapolda jateng tindak tegas	negative
polda kalbar tangkap tambang emas ilegal	negative
video gangster venezuela kuasa penjara ribu tentara serbu	neutral
ppatk ungkap nilai transaksi tambang ilegal cs tembus rp t	negative
tambang liar situbondo operasi malam hari hindar razia	negative
kompolnas saran polri libat ppatk usut kasus suap ismail bolong	neutral
tambang timah ilegal babel luar biasa tak sentuh	negative
tambang ilegal tangkap babel polisi sita ton pasir timah	negative
korban bakar suling minyak ilegal langkat akhir tinggal	negative
kode langit tujuh beking ngeri tambang ilegal apa maksud	negative
polisi tangkap bos tambang emas ilegal bogor	negative
polisi selidik mati tani anti tambang lumajang	neutral
gurandil tambang emas pongkor terus bersih	neutral
tolak tambang pasir liar aktivis lempari telur kantor dprd tulungagung	negative
peran eks dirops pt timah kasus korupsi rp t	neutral
rapat kapolda jatim dpr sorot tuntas kasus tambang lumajang	neutral
wamen esdm bocor minerba banyak labuh tikus	positive
walhi jateng masalah tambang pasir tak sekadar izin	neutral
tumbal darah salim kancil	neutral
tambang ilegal sebab hektare sawah cilacap gagal panen tahun	negative
kiwoom securities bursa regional beri dukung	neutral
fakta harvey moeis suami sandra dewi sangka korupsi komoditas timah	neutral
benny k harman kan mafia tanah hukum tumbuh subur labu bajo	neutral
tertib tambang emas ilegal kuansing riau akhir rusuh	negative
rusak lingkung alat sedot tambang pasir ilegal sita	negative
beking ngeri tambang ilegal klaten	negative
lihat teknologi tambang timah ramah lingkung bangka	positive
bangun masa depan dunia lebih aman ajar afghanistan	neutral
dinas esdm sulsel pasti tambang pasir keluh warga gowa ilegal	negative
jember tolak tambang silo respons menteri esdm	neutral
marak aktivitas tambang izin amat peti jahat	neutral
duduk perkara harvey moeis suami sandra dewi sangka korupsi komoditas timah	neutral
apa picu longsor nganjuk kata teliti bencana its	neutral
kerbau mati pulau buru duga minum limbah tambang emas	negative
polres bangka razia tambang timah ilegal kawasan sumber air pdam	negative
brasil jelang duel lula da silva lawan jair bolsonaro	neutral
kira ladang ganja nyata tambang bitcoin ilegal	negative
jerat sangka korupsi timah crazy rich pik hingga suami sandra dewi	negative
momen harvey moeis suami sandra dewi giring mobil tahan jagung	neutral
nah loh bitcoin larang negara negara	neutral
tambang emas ilegal subur kalbar aparat jabat jadi beking	negative
usaha tambang imbau tanggung jawab jalan rusak	neutral
pemkab bungo jambi periksa kades kait duga setor tambang emas ilegal	negative
cara perintah berantas tambang timah ilegal	negative
tambang pasir ilegal batam tangkap alat berat sita	negative
asai talib afghanistan nyata sangat gantung hibah asing	positive
horor tambang emas ilegal sulteng tewas gegara longsor	negative
tambang emas ilegal nagan raya gerebek orang backhoe aman	negative
rusa imbas tambang timah seret harvey moeis kali luas jakarta	neutral
duh tambang pasir ilegal marak pantai dompu ntb	negative
konjuk ngarsadalem sultan ulah tambang liar sungai progo keluh	negative
kades hariyono nyanyi sebut aktivis anti tambang terima uang	neutral
kapolres batang ungkap rencana legal tambang gali c liar kit	negative
kasus yang bikin harvey moeis suami sandra dewi tahan jagung	neutral
tambang sirtu ilegal jatim tutup	negative
timah babel selundup harta karun mahal dalam	negative
peran kunci suami sandra dewi korupsi timah bongkar tambang ilegal	negative
lewat cara bumn ikut genjot pnbp sektor minerba	neutral
ular unik mata oranye beri nama leonardo dicaprio	positive
tambang emas ilegal taman nasional lore lindu sigi tangkap klhk	negative
mafia tambang timah cukong malaysia thailand	neutral
xi jinping keras china sikat usaha kripto ilegal	negative
wabup lebak bantah tambang emas ilegal sebab banjir longsor	negative
wujud bola emas hasil tambang ilegal cibuluh sukabumi	negative
talib kuasa rp triliun kaya mineral afghanistan masuk lithium	neutral
tambang ilegal halimun salak polisi laku telusur	negative
polisi tutup tambang emas ilegal madina ekskavator sita	negative
kisah uten tahun jadi gurandil tambang rakyat	positive
perintah kapolri kapolda jatim soal bancak uang tambang lumajang	neutral
jadi sangka ini peran crazy rich helena lim kasus korupsi timah	positive
tekad jokowi jadi ri raja timah dunia	neutral
sadis kkb datang lalu bunuh tambang emas gunung bintang papua	neutral
ferdy sambo temu alir dana jabat polri kasus ismail bolong	neutral
acara ismail bolong tahan kasus tambang tak suap pati polri	neutral
crazy rich helena lim jadi sangka jagung langsung tahan	negative
kepala bnpb longsor sukajaya sangat masif ibarat es krim leleh	neutral
polisi ungkap peran tambang pasir ilegal batam	negative
korban tambang emas runtuh kongo tambah jadi orang	neutral
tambang bitcoin diam diam usaha ancam denda rp m	positive
tambang ilegal tnll aktif tambang asal manado luka bacok	negative
menteri sus kecam tambang pasir fakfak	neutral
polri limpah berkas perkara ismail bolong jagung besok	positive
upaya istri mendiang salim kancil periksa polisi juang tanah	negative
warga keluh tambang ilegal klaten gibran beking ngeri	negative
tragedi minamata ancam indonesia	neutral
tambang sirtu ilegal pasuruan tutup paksa	negative
tutup tambang timah ilegal kantor gubernur habis	negative
polisi musnah alat tambang emas ilegal riau tambang kabur	negative
begini duga kongkalikong suami sandra dewi eks dirut timah	negative
tindak pidana turun polisi bojonegoro sebut selesai kasus naik	neutral
tambang pasir mojokerto tewas kerja tutup	negative
tim gabung tutup lubang gali tambang liar jember	negative
turun tangan dinas esdm sulsel tindak tambang pasir ilegal gowa	negative
cerita gurandil soal bisnis emas ilegal tnghs sebab longsor lebak	negative
jagung tetap sangka baru kasus korupsi komoditas timah	positive
polisi dihadang warga hendak tangkap laku tambang ilegal	negative
polda jatim tetap sangka tambang liar pasir lumajang	negative
ribu gurandil cari emas tambang legenda pongkor	positive
alas marak tambang ilegal indonesia	negative
tambang emas bukit prabu dekat mandalika henti	positive
orang tewas kena longsor alex noerdin minta tindak tambang batu bara liar	negative
sangka barang bukti tambang ilegal pasuruan serah jaksa	negative
waduh tambang gali c ilegal marak kabupaten batang	negative
polisi musnah mesin tambang emas liar riau tambang kabur	negative
ritual tambang emas ilegal tnghs potong kambing bakar kemenyan	negative
punya tambang emas liar berapa gaji briptu hasbudi si polisi tajir	positive
landa wabah malaria venezuela kurang obat obat	neutral
orang jebak tambang emas ilegal pancurendang banyumas sejak	negative
menperin thailand tak punya timah bisa ekspor	neutral
jagung jerat windu aji sutanto sangka kasus antam langsung tahan	positive
kodam mulawarman bangun posko kontainer bekas lokasi jokowi kemah ikn	negative
ferdy sambo lapor jabat polri terima dana tambang kapolri	neutral
acara ismail bolong jerat pasal tambang ilegal	negative
gerebek sumur minyak ilegal muaro jambi polisi tangkap orang kerja	negative
nyala rakit tambang emas ilegal bungo bakar tugas	neutral
tumbal darah salim kancil	neutral
lebih bulan sembur api sumur minyak ilegal jambi akhir padam	neutral
peran harvey moeis suami sandra dewi kasus korupsi timah	neutral
diam harvey moeis pakubuwono geledah jagung	neutral
hutan larang baduy rusak gurandil kapolda banten tindak tegas	positive
sudirman said lapor soal illegal mining jokowi	negative
salim kancil lawan tanah gusur kades parkir	neutral
cerita berani kombes hendy kurniawan berantas mafia tambang ilegal kaltara	negative
kkb papua pimpin bocor sobolim pernah bantai jaga kios hingga tewas	neutral
tampak ismail bolong baju tahan usai jadi sangka tambang ilegal	negative
pertamina ep rebut sumur minyak asai tambang liar	negative
tambang emas ilegal sulut tewas timbun longsor	negative
polres sukabumi bekuk tambang emas ilegal produsen pupuk palsu	negative
komisi iii dpr bakal tanya polri soal aku sambo kasus tambang	neutral
momen akhir tambang emas jebak lubang nyata hilang	negative
tambang emas ilegal aceh tangkap	negative
harga batu bara anjlok sempat perintah tertib tambang ilegal	negative
longsor tambang ilegal kalsel tewas orang modal sangka	negative
gubernur banten tunggu putus lhk tutup tambang liar	negative
buka buka gibran sebut beking ngeri tambang ilegal klaten	negative
satgas csp mine investasi bodong korban segera lapor polisi	neutral
geram bupati dedi palang mobil damkar gali tanah ilegal	negative
polisi gerebek lokasi duga ladang ganja eh nyata tambang bitcoin	negative
ngenes opium jadi motor utama gerak ekonomi afghanistan	positive
klhk tangkap cukong tambang ilegal hutan mangrove belitung timur	negative
cerita balik batu permata langka bikin tambang kaya raya	positive
sus cari anak sma juara jadi doktor bahari luar negeri	positive
jurus kkp henti tambang pasir laut ilegal air pulau rupat	negative
mau perang tampak kapal tambang timah ilegal babel	negative
menteri desa minta tambang ilegal desa desa segera tertib	negative
polisi segel gudang simpan batu hitam galena ilegal bone bolango	negative
polda jatim usut teror ancam bunuh wartawan lumajang	neutral
tambang emas banyumas tutup kades galau banyak warga nganggur	positive
polisi tumpas tambang pasir ilegal bintan kepri	negative
polisi tutup sumur minyak ilegal sumsel orang tangkap	negative
tambang timah longsor tewas kerja bangka tak izin	negative
mediasi warga desa soal tambang emas ilegal hutan adat final	negative
disidak satpol pp kerja tambang ilegal batang lari kocar kacir	negative
tak atur internasional jerman larang transaksi bitcoin	neutral
ganjar bentuk tim puser bumi buat atas tambang liar sragen	negative
cegah barang ilegal tambang timah tak izin putih	negative
wartawan bangka siram air keras pria misterius tanya alamat	neutral
bos gembong narkoba paling cari kolombia tangkap	positive
harga timah lemah apa	neutral
tujuh tambang timah ilegal bangka barat aman polisi	negative
timah ilegal ri jual malaysia esdm sudah rahasia umum	negative
tambang emas ilegal luwu utara longsor timpa tambang orang tewas	negative
korban tewas tambang ilegal longsor sumbar jadi orang	negative
tanah nyaris hilang warga kalong tutup paksa gali c	neutral
blh banyuwangi desak tutup tambang liar	negative
perintah bakal sanksi usaha tambang belum setor negara	neutral
lingkung rusak warga tegal blokir tambang pasir	neutral
lahan bekas tambang bisa manfaat contoh	neutral
oknum polisi orang orang juga terima uang mitra kades	neutral
kisah dedengkot gurandil pongkor hijrah jadi pahlawan lingkung	neutral
polisi buru milik sumur minyak ilegal bakar batanghari	negative
viral ambil pasir besi sukabumi begini fakta	neutral
laku illegal drilling tangkap muaro jambi nyata oknum pns	negative
pro kontra tambang emas bukit prabu sekitar mandalika	neutral
siapa ismail bolong sebar hingga ralat isu setor miliar kabareskrim	negative
pemda malu tertib tambang emas ilegal gunung gotak	negative
ma hukum bos usaha illegal mining bulan penjara	negative
kerja tambang emas ilegal pohuwato tangkap ekskavator sita	negative
polisi bakar alat tambang emas ilegal riau	negative
wn sri lanka deportasi gegara jadi tambang emas ilegal gorontalo	negative
gegara marak tambang ilegal menteri esdm mau bikin ditjen baru	negative
tutup gali c ilegal tugas gabung bersitegang warga	negative
ciduk patroli puluh tambang timah ilegal laut belinyu setop	negative
acara heran hendra kurniawan tak daya bawa bawa ismail bolong	positive
kapolda malu cek lokasi tambang emas ilegal pulau buru	negative
jangan pakai ciri ciri kondom palsu	negative
hutan rusak sungai cari gurandil jambi malah lawan polisi	neutral
sumur minyak ilegal ledak cemar sungai pemkab muba ngadu klhk	negative
pvmbg ungkap sebab fenomena tanah geser rusak rumah warga bima	neutral
laku tambang ilegal hutan lindung babel vonis tahun	negative
kelola gunung halimun aku tambang ilegal ada sejak lama	negative
siapa ismail bolong cabut nyata setor miliar kabareskrim	neutral
wujud rusa jalan akibat gali ilegal buat bupati dedi geram	negative
meski protes ratus warga kejar mojokerto tetap tahan kades lebakjabung	neutral
salim kancil tewas kompolnas rapat lumajang usut duga lalai polisi	neutral
sumur minyak ilegal bakar langkat orang luka	negative
tumpuk kerja rumah sambut kapolda papua barat	neutral
bupati lebak sebut tambang emas ilegal bukan tanggung jawab pemkab	negative
tega tambang batu bara ilegal rambah makam corona	negative
ribu alat tambang bitcoin lindas pakai stoom	neutral
bos pt timah ungkap produksi turun tahun turut turut	neutral
tambang pasir sungai cikao purwakarta tutup	negative
mantan gurandil pongkor hijrah jadi tani sayur hidup lebih nyaman	positive
tambang timah laut tewas timbun tanah longsor selam	neutral
walhi sulsel minta bupati maros tindak tambang ilegal picu banjir	negative
longsor bogor sebut imbas tambang emas liar gunung sanggabuana	negative
china tinggal tambang bitcoin suka razia	neutral
tambang ilegal sebut gibran beking ngeri tak operasi	negative
usai kucing kucing polisi tiga bos tambang ilegal jateng bekuk	negative
waka komisi vii dpr dukung gibran cabut izin tambang usaha nakal	neutral
eks kapolsek anggota aku tak tahu tambang pasir liar	negative
transaksi ilegal ton sabar bongkar laku tangkap	negative
tambang emas ilegal makan korban kalbar tambang tewas timbun	negative
kepras bukit ilegal tambang ringkus polisi	negative
deru suara diesel tambang emas ilegal gunung sanggabuana	negative
pbb capai sepakat sejarah lindung laut lepas	positive
heboh beking tambang ilegal klaten komisi vii dpr sorot tega hukum	negative
heboh tambang ilegal menteri esdm kirim tim inspektur klaten	negative
nyanyi ismail bolong periksa anak buah sambo soal tambang ilegal	negative
gubernur edy minta polisi sikat tambang ilegal usah koordinasi tindak	negative
negara bungkus emas sakral	neutral
jelas bupati lumajang soal tambang pasir selok awar awar	neutral
tambang gali c ilegal ranu grati pasuruan tutup	negative
polres lumajang bantah biar ilegal mining	negative
bareskrim sita tumpu batu bara hingga truk kasus ismail bolong	neutral
polisi brasil sebut jurnalis pakar adat hilang amazon tewas tembak	negative
emas hasil tambang ilegal bungo jual sumbar	negative
tambang ilegal sebab banjir longsor bogor polri patroli skala besar	negative
polisi tangkap tambang ilegal bungo kg emas sita	negative
polisi tetap sangka ledak sumur minyak aceh timur	neutral
bupati minta polisi berantas tambang emas ilegal aceh barat	negative
china ngamuk larang keras transaksi tambang kripto	negative
warga probolinggo wadul dprd jatim soal tambang liar	negative
detik detik tambang emas ilegal parimo timpa longsor hingga tewas	negative
cara tekan tambang ilegal sumber timah besar dunia	negative
polisi tangkap tampung emas hasil tambang ilegal kuansing riau	negative
ombudsman prihatin marak tambang ilegal indikasi backup aparat	negative
polisi tangkap orang angkut ton minyak ilegal jambi	negative
sempat gerebek tambang pasir ilegal malang klaten operasi	negative
wagub sumut soal efek buruk tambang ilegal madina	negative
maki minta mahfud lapor kasus mafia tambang kaltim kalsel jokowi	neutral
polisi buru milik tambang batu bara ilegal bawa senpi mana mana	negative
duga korupsi rp m walhi lapor hutan kpk	negative
sangka duga korupsi timah babel tambah jagung tahan orang	negative
kisah ikan kaca papua habitat ancam tambang emas ilegal	negative
suku amazon blokir jalan tuntut bantu corona perintah	neutral
polisi ungkap tambang merkuri ilegal sidoarjo laku tangkap	negative
wapres bicara siap pres kait tambang emas ilegal lebak	negative
ismail bolong ngaku tekan brigjen hendra soal setor uang kabareskrim	negative
tambang pasir probolinggo tewas timbun tebing longsor	neutral
soal manuver ismail bolong mahfud singgung isu perang bintang	neutral
sumur minyak ilegal jambi bakar kerja tewas	negative
foto foto nasa ungkap ada sungai emas amazon	neutral
ratus ton timah ilegal ekspor kandung uranium hingga tanah jarang	negative
polisi naik status tambang ilegal madina orang jadi sangka	negative
kuak apple sempat minat bangun pabrik ri mundur gegara	positive
puluh orang daerah kumuh afrika selatan tewas imbas bocor gas	negative
afrika desak raja inggris kembali berlian mahkota ratu elizabeth ii	neutral
polda banten tangkap tambang emas ilegal lebak	negative
polisi tangkap laku tambang ilegal kaltim orang sangka	negative
